1111111111111111111111
1010001011101110101111
1010101111111111111011
1000000000000000001111
10P0C00C101010000000E1
1111111111111111111111